################
#X    @        #
# #            #
# #          # #
# #          # #
# #   G S    # #
# #        S # #
# #    S     # #
# #     C    # #
# # V        # #
# #          # #
# #    L     # #
# #          # #
# ############ #
#              #
################
