################
#X    @        #
# #            #
# #          # #
# #          # #
# #   G D    # #
# #        S # #
# #    S     # #
# #     C    # #
# #          # #
# #          # #
# #          # #
# #          # #
# ############ #
#              #
################
